WWWWWWWWWWWWWWWWWWWWWWWWWWWWWWWWWWWWWWWWWWWWWWWWW
WFFFFFWWFWWWFWWFFFFFWWWWWWWWWFFFFFWWFWWWFWWFFFFWW
WWWFWWWWFWWWFWWFWWWWWWWWWWWWWFWWWWWWFFWWFWWFWWWFW
WWWFWWWWFFFFFWWFFFWWWBWRWOWWWFFFWWWWFWFWFWWFWWWFW
WWWFWWWWFWWWFWWFWWWWWWWWWWWWWFWWWWWWFWWFFWWFWWWFW
WWWFWWWWFWWWFWWFFFFFWWWWWWWWWFFFFFWWFWWWFWWFFFFWW
WWWWWWWWWWWWWWWWWWWWWWWWWWWWWWWWWWWWWWWWWWWWWWWWW