  WWWWW
WWWFFFW
WORBFFW
WWWFBOW
WOWWBFW
WFWFOFWW
WBFDBBOW
WFFFOFFW
WWWWWWWW