    WWWWW
    WFFFW
    WBFFW
  WWWFFBWW
  WFFBFBFW
WWWFWFWWFWFFFWWWWWW
WFFFWFWWFWWWWWFFOOW
WFBFFBFFFFFFFFFFOOW
WWWWWFWWWFWRWWFFOOW
    WFFFFFWWWWWWWWW
    WWWWWWW